You seem to notice some things are out of place so you decide to investigate. You find out that aliens have invaded and have locked you in your house. You need to find a way to get out and stop them! Hint: the second key can be door key or key2.

Paranormal Life
Aliens Invade! by Jackie Wu
Release 1 / Serial number 170227 / Inform 7 build 6M62 (I6/v6.33 lib 6/12N) SD

Living Room
Your normal living room. The walls are adorned by art. West of the living room is the east hallway.

>i
You are carrying nothing.

>n
You can't go that way.

>w
East Hallway

>ne
Storage Room
You can see a key and a trapdoor (closed) here.

>take all
There are none at all available!

>take key
That's fixed in place.

* * *

You seem to notice some things are out of place so you decide to investigate. You find out that aliens have invaded and have locked you in your house. You need to find a way to get out and stop them! Hint: the second key can be door key or key2.

Paranormal Life
Aliens Invade! by Jackie Wu
Release 1 / Serial number 170227 / Inform 7 build 6M62 (I6/v6.33 lib 6/12N) SD

Living Room
Your normal living room. The walls are adorned by art. West of the living room is the east hallway.

>w
East Hallway
The east hall. West of here is the west hallway. South is Kelly's bedroom and northeast is the storage room. Go east to go back to the living room.

>n
You can't go that way.

>ne
Storage Room
You can see a key, a rug and a trapdoor here.

>open trapdoor
It isn't something you can open.

* * *

>w
East Hallway
The east hall. West of here is the west hallway. South is Kelly's bedroom and northeast is the storage room. Go east to go back to the living room.

>ne
Storage Room
There's loads of stuff here. You notice a trapdoor and something shiny. Southwest is the east hallway.

You can see a key and a trapdoor (closed) here.

>open trapdoor
You open the trapdoor, revealing a sword.

>take sword
Taken.

>sw
East Hallway
The east hall. West of here is the west hallway. South is Kelly's bedroom and northeast is the storage room. Go east to go back to the living room.

>ne
Storage Room
There's loads of stuff here. You notice a trapdoor and something shiny. Southwest is the east hallway.

You can see a key and a trapdoor (empty) here.

>take key
Taken.

>sw
East Hallway
The east hall. West of here is the west hallway. South is Kelly's bedroom and northeast is the storage room. Go east to go back to the living room.

>e
Living Room
Your normal living room. The walls are adorned by art. West of the living room is the east hallway.

>w
East Hallway
The east hall. West of here is the west hallway. South is Kelly's bedroom and northeast is the storage room. Go east to go back to the living room.

>w
West Hallway
The west hallway. East of here is the east hallway. South is your grandparent's room and north is your room.

>s
Grandparent's Room
Your grandparent's room. What more can I say about it. Northwest is their closet. North is the west hallway.

>nw
Grandparent's Closet
There's just a lot of clothes here. But there also seems to be a chest. Southeast is the way back.

You can see a chest (closed) here.

>unlock chest with key
You unlock the chest.

>open chest
You open the chest, revealing a book.

>take key 2
I only understood you as far as wanting to take the key.

>take key2
Taken.

>se
Grandparent's Room
Your grandparent's room. What more can I say about it. Northwest is their closet. North is the west hallway.

>n
West Hallway
The west hallway. East of here is the east hallway. South is your grandparent's room and north is your room.

>n
Jackie's Room
You can see a Wooden Door here.

>unlock wooden door with door key
You unlock the Wooden Door.

>s
West Hallway
The west hallway. East of here is the east hallway. South is your grandparent's room and north is your room.

>w
You can't go that way.

>e
East Hallway
The east hall. West of here is the west hallway. South is Kelly's bedroom and northeast is the storage room. Go east to go back to the living room.

>e
Living Room
Your normal living room. The walls are adorned by art. West of the living room is the east hallway.

>take sandwich
Taken.

>w
East Hallway
The east hall. West of here is the west hallway. South is Kelly's bedroom and northeast is the storage room. Go east to go back to the living room.

* * *

>w
West Hallway
The west hallway. East of here is the east hallway. South is your grandparent's room and north is your room.

>n
Jackie's Room
You can see a Wooden Door here.

>n
(first opening the Wooden Door)

backyard
Just a normal backyard...with some alien life forms. South of here is your room. West is inside the space ship.

You can see a Wooden Door here.

>w
AlienSpaceshipInterior
You enter the ship to be amazed by the technology developed by the aliens. East is the backyard, North is the alien kitchen.

>n
Alien Kitchen.
There's a lot of high tech mumbo jumbo everywhere. I think there is some sort of person here.

You can see an Alien here.

>give sandwich to alien
You hand the sandwich over to the alien. He makes a weird garble sound. It sounded like he thanked you. He pulls out a note, and a key, and hands you the note and key. You feel good about yourself because you helped someone out.

>i
You are carrying:
  a final key
  Note
  a key2
  a key
  a sword

>s
AlienSpaceshipInterior
You enter the ship to be amazed by the technology developed by the aliens. East is the backyard, North is the alien kitchen.

>n
Alien Kitchen.
There's a lot of high tech mumbo jumbo everywhere. I think there is some sort of person here.

You can see an Alien here.

>s
AlienSpaceshipInterior
You enter the ship to be amazed by the technology developed by the aliens. East is the backyard, North is the alien kitchen.

>w
Power Glove Room
There's a lot of power gloves but they all seem to be frozen in place. But one of them looks like they aren't. North is the library, Northwest is the Alien Living Quarters, Northeast is the Alien Living Room.

You can see Power glove here.

>n
Library
Alien books filled the room. There doesn't seem to be anyone here. South of here is the Power Glove Room.

You can see Bookcase here.

>n
You can't go that way.

>open door
You open the Secret Door.

>n
You can't go that way.

>north
You can't go that way.

>w
You can't go that way.

>e
You can't go that way.

>s
Power Glove Room
There's a lot of power gloves but they all seem to be frozen in place. But one of them looks like they aren't. North is the library, Northwest is the Alien Living Quarters, Northeast is the Alien Living Room.

You can see Power glove here.

>n
Library
Alien books filled the room. There doesn't seem to be anyone here. South of here is the Power Glove Room.

You can see Bookcase here.

* * *

>n
You can't go that way.

>n
You can't go that way.

>open secret door
That's already open.

>enter secret door
You can't go that way.

>s
Power Glove Room
There's a lot of power gloves but they all seem to be frozen in place. But one of them looks like they aren't. North is the library, Northwest is the Alien Living Quarters, Northeast is the Alien Living Room.

You can see Power glove here.

>take power glove
Taken.

>wear power glove
You put on Power glove.

>n
Library
Alien books filled the room. There doesn't seem to be anyone here. South of here is the Power Glove Room.

You can see Bookcase here.

>push bookcase south
You push Bookcase south to Power Glove Room.

Power Glove Room
There's a lot of power gloves but they all seem to be frozen in place. But one of them looks like they aren't. North is the library, Northwest is the Alien Living Quarters, Northeast is the Alien Living Room.

>push bookcase ne
You push Bookcase northeast to Alien Living Room.

Alien Living Room
High tech stuff everywhere. I can't tell what everything is. Southwest of here is the Power Glove Room.

You can see Dining table here.

>push dining table sw
You push Dining table southwest to Power Glove Room.

Power Glove Room
There's a lot of power gloves but they all seem to be frozen in place. But one of them looks like they aren't. North is the library, Northwest is the Alien Living Quarters, Northeast is the Alien Living Room.

>push dining table nw
You push Dining table northwest to Alien Living Quarters.

Alien Living Quarters
Your normal alien living quarters. Very high tech. Even the bed. Southeast from here is the Power Glove Room.

You can see Bed here.

>push bed se
You push Bed southeast to Power Glove Room.

Power Glove Room
There's a lot of power gloves but they all seem to be frozen in place. But one of them looks like they aren't. North is the library, Northwest is the Alien Living Quarters, Northeast is the Alien Living Room.

>push bed n
You push Bed north to Library.

Library
Alien books filled the room. There doesn't seem to be anyone here. South of here is the Power Glove Room.

>look
Library
Alien books filled the room. There doesn't seem to be anyone here. South of here is the Power Glove Room.

You can see Bed and a Secret Door here.

>north
Hidden Room
There seems to be one last door. But it's locked. Maybe the alien you met can help. South is the Library.

You can see a Secret Door and Final door here.

>unlock final door with final key
You unlock Final door.

>north
(first opening Final door)

AlienCockpit
You can see Final door here.

You see the switch to stop orders to take over earth. Quickly, you flick the switch. Big red words appear on the glass of the cock pit saying things in an alien language. It's over...

    *** The End ***

Would you like to RESTART, RESTORE a saved game, QUIT or UNDO the last command?

* * *

>take sword
Taken.

>take key
Taken.

>se
You can't go that way.

>sw
East Hallway
The east hall. West of here is the west hallway. South is Kelly's bedroom and northeast is the storage room. Go east to go back to the living room.

>w
West Hallway
The west hallway. East of here is the east hallway. South is your grandparent's room and north is your room.

* * *

>open chest
You open the chest, revealing a book.

>x book
Pay...ATTENTION...To..THE..INSIDE

The book feels a little heavy.

>take door key
Taken.

>se
Grandparent's Room
Your grandparent's room. What more can I say about it. Northwest is their closet. North is the west hallway.

* * *

>unlock wooden door with door key
You unlock the Wooden Door.

>n
(first opening the Wooden Door)

backyard
You can see a Wooden Door here.

>w
AlienSpaceshipInterior
You enter the ship to be amazed by the technology developed by the aliens.

>n
Alien Kitchen.
There's a lot of high tech mumbo jumbo everywhere. I think there is some sort of person here.

You can see an Alien here.

>n
You can't go that way.

>w
You can't go that way.

* * *

>e
You can't go that way.

>s
AlienSpaceshipInterior
You enter the ship to be amazed by the technology developed by the aliens.

>n
Alien Kitchen.
There's a lot of high tech mumbo jumbo everywhere. I think there is some sort of person here.

You can see an Alien here.

I beg your pardon?

>s
AlienSpaceshipInterior
You enter the ship to be amazed by the technology developed by the aliens.

>w
Power Glove Room
There's a lot of power gloves but they all seem to be frozen in place. But one of them looks like they aren't.

You can see Power glove here.

>take power glove
Taken.

* * *

>wear power glove
You put on Power glove.

>n
Library
Alien books filled the room. There doesn't seem to be anyone here.

You can see Bookcase here.

>push bookcase to Alien living room
You can't see any such thing.

>push Bookcase to
What do you want to push Bookcase to?

>alien living room
You can't see any such thing.

>Alien Living Room
That's not a verb I recognise.

>push bookcase to
What do you want to push Bookcase to?

>AlienLivingRoom
You can't see any such thing.

>push bookcase to
What do you want to push Bookcase to?

>w
You can't go that way.

>push book case to alien living room
You can't see any such thing.

>push bookcase to alien living room
You can't see any such thing.

>push Bookcase to Alien Living Room
You can't see any such thing.

>look
Library
Alien books filled the room. There doesn't seem to be anyone here.

You can see Bookcase here.

>push bookcase to alien living room
You can't see any such thing.

>push bookcase to power glove room
You can't see any such thing.

>loo
That's not a verb I recognise.

>look
Library
Alien books filled the room. There doesn't seem to be anyone here.

You can see Bookcase here.

>push bookcase south
You push Bookcase south to Power Glove Room.

Power Glove Room
There's a lot of power gloves but they all seem to be frozen in place. But one of them looks like they aren't.

>s
You can't go that way.

>e
AlienSpaceshipInterior
You enter the ship to be amazed by the technology developed by the aliens.

>look
AlienSpaceshipInterior
You enter the ship to be amazed by the technology developed by the aliens.

>n
Alien Kitchen.
There's a lot of high tech mumbo jumbo everywhere. I think there is some sort of person here.

You can see an Alien here.

>w
You can't go that way.

>w
You can't go that way.

>s
AlienSpaceshipInterior
You enter the ship to be amazed by the technology developed by the aliens.

>w
Power Glove Room
There's a lot of power gloves but they all seem to be frozen in place. But one of them looks like they aren't.

You can see Bookcase here.

>push bookcase ne
You push Bookcase northeast to Alien Living Room.

Alien Living Room
High tech stuff everywhere. I can't tell what everything is.

You can see Dining table here.

>push dining table sw
You push Dining table southwest to Power Glove Room.

Power Glove Room
There's a lot of power gloves but they all seem to be frozen in place. But one of them looks like they aren't.

>push dining table nw
You push Dining table northwest to Alien Living Quarters.

Alien Living Quarters
Your normal alien living quarters. Very high tech. Even the bed.

You can see Bed here.

>push bed se
You push Bed southeast to Power Glove Room.

Power Glove Room
There's a lot of power gloves but they all seem to be frozen in place. But one of them looks like they aren't.

>push bed n
You push Bed north to Library.

Library
Alien books filled the room. There doesn't seem to be anyone here.

>look
Library
Alien books filled the room. There doesn't seem to be anyone here.

You can see Bed and a Secret Door here.

>open secret door
You open the Secret Door.

>north
Hidden Room
You can see a Secret Door and Final door here.

>north
(first opening Final door)
It seems to be locked.

>north
(first opening Final door)
It seems to be locked.

>open final door
It seems to be locked.

>snail
That's not a verb I recognise.

>cast spell
That's not a verb I recognise.

>cast snail
That's not a verb I recognise.

>say snail
(to yourself)
There is no reply.

>a snail
That's not a verb I recognise.

>cast a snail
That's not a verb I recognise.

>cast snail
That's not a verb I recognise.

* * *

>ne
Storage Room
There's loads of stuff here. You notice a trapdoor and something shiny. Southwest is the east hallway.

You can see a key and a trapdoor (closed) here.

>take key
Taken.

>take trapdoor
That's fixed in place.

>open trapdoor
You open the trapdoor, revealing a sword.

* * *

>w
West Hallway
The west hallway. East of here is the east hallway. South is your grandparent's room and north is your room.

>s
Grandparent's Room

>ne
You can't go that way.

>nw
Grandparent's Closet
You can see a chest (closed) here.

>take chest
That's fixed in place.

>unlock chest with key
You unlock the chest.

* * *

>x book
Pay...ATTENTION...To..THE..INSIDE

The book feels a little heavy.

>take key2
Taken.

>sw
You can't go that way.

>se
Grandparent's Room

>n
West Hallway
The west hallway. East of here is the east hallway. South is your grandparent's room and north is your room.

* * *

>n
Jackie's Room
You can see a Wooden Door here.

>unlock wooden door with key2
You unlock the Wooden Door.

>open door
You open the Wooden Door.

>n
backyard
You can see a Wooden Door here.

>w
AlienSpaceshipInterior

>w
Power Glove Room
You can see Power glove here.

>n
Library
You can see a Bookcase here.

>x alien
You can't see any such thing.

>move sandwich to Jackie's Room
You can't see any such thing.

>Move Power Glove to Alien Kitchen
You can't see any such thing.

>s
Power Glove Room
You can see Power glove here.

>s
You can't go that way.

>w
You can't go that way.

>e
AlienSpaceshipInterior

>move power glove to library
You can't see any such thing.

>look
AlienSpaceshipInterior

>w
Power Glove Room
You can see Power glove here.

>take power glove
Taken.

>s
You can't go that way.

>e
AlienSpaceshipInterior

>s
You can't go that way.

>w
Power Glove Room

>nw
Alien Living Quarters
You can see a Bed here.

>move bed to library
You can't see any such thing.

>move bed with power glove
You can't see any such thing.

>s
You can't go that way.

>e
You can't go that way.

>sw
You can't go that way.

>se
Power Glove Room

>nw
Alien Living Quarters
You can see a Bed here.

>move bed with power glove
You can't see any such thing.

>push bed
Nothing obvious happens.

>push bed to Library
You can't see any such thing.

>look
Alien Living Quarters
You can see a Bed here.

>push bed to library
You can't see any such thing.

I beg your pardon?

>move bed to library
You can't see any such thing.

>look
Alien Living Quarters
You can see a Bed here.

>move bed
Nothing obvious happens.

>moving bed
That's not a verb I recognise.

>move bed to library
You can't see any such thing.

>move bed
Nothing obvious happens.

* * *

>w
East Hallway
The east hall. West of here is the west hallway. South is Kelly's bedroom and northeast is the storage room. Go east to go back to the living room.

>nw
You can't go that way.

>ne
Storage Room
You can see a key and a trapdoor (closed) here.

>take
What do you want to take?

>take all
There are none at all available!

>drop trapdoor
The trapdoor is already here.

>sw
East Hallway

>w
West Hallway

>s
Grandparent's Room

>nw
Grandparent's Closet
You can see a chest (closed) here.

>unlock chest
(with the chest)
(first taking the chest)
That doesn't seem to fit the lock.

>open chest
It seems to be locked.

>x book
You can't see any such thing.

>take door key
You can't see any such thing.

>sw
You can't go that way.

* * *

>se
Grandparent's Room

>n
West Hallway

>n
Jackie's Room
You can see a Wooden Door here.

>open door
It seems to be locked.

>unlock door
(with the chest)
That doesn't seem to fit the lock.

>unlock door with door key
I only understood you as far as wanting to unlock the Wooden Door with the Wooden Door.

>n
Living Room
You feel scared without a weapon. You head back to the living room.

>n
You can't go that way.

* * *

>w
East Hallway

>s
Kelly's Bedroom
You can see a desk (closed) here.

>n
East Hallway

>s
Kelly's Bedroom
You can see a desk (closed) here.

>i
You are carrying:
  a chest (closed and locked)

>n
East Hallway

>talk to
That's not a verb I recognise.

>s
Kelly's Bedroom
You can see a desk (closed) here.

>take desk
That's fixed in place.

>n
East Hallway

>ne
Storage Room
You can see a key and a trapdoor (closed) here.

>open trapdoor
You open the trapdoor, revealing a sword.

* * *

>take sword
Taken.

>s
You can't go that way.

>s
You can't go that way.

>sw
East Hallway

* * *

>w
West Hallway

>n
Jackie's Room
You can see a Wooden Door here.

>n
(first opening the Wooden Door)
It seems to be locked.

>open the door
It seems to be locked.

>unlock wooden door with key2
You can't see any such thing.

>i
You are carrying:
  a sword
  a chest (closed and locked)

>s
West Hallway

>e
East Hallway

>nw
You can't go that way.

>ne
Storage Room
You can see a key and a trapdoor (empty) here.

>take key
That's fixed in place.

>open chest
It seems to be locked.

>unlock chest
What do you want to unlock the chest with?

>unlock chest with key
(first taking the key)
That's fixed in place.

* * *

>ne
Storage Room
You can see a key and a trapdoor (closed) here.

>take key
Taken.

>open trapdoor
You open the trapdoor, revealing a sword.

* * *

>take sword
Taken.

>sw
East Hallway

* * *

>nw
Grandparent's Closet
You can see a chest (closed) here.

>unlock chest
What do you want to unlock the chest with?

>unlock chest with key
You unlock the chest.

* * *

>x book
Pay...ATTENTION...To..THE..INSIDE

The book feels a little heavy.

>take key
You already have that.

>take door key
Taken.

>leave
But you aren't in anything at the moment.

>s
You can't go that way.

* * *

>w
You can't go that way.

>nw
You can't go that way.

>sw
You can't go that way.

* * *

>open door
It seems to be locked.

>unlock door
What do you want to unlock the Wooden Door with?

>unlock door with door key
You unlock the Wooden Door.

>n
(first opening the Wooden Door)

backyard
You can see a Wooden Door here.

>n
You can't go that way.

>s
Jackie's Room
You can see a Wooden Door here.

>n
backyard
You can see a Wooden Door here.

>s
Jackie's Room
You can see a Wooden Door here.

* * *

>n
backyard
You can see a Wooden Door here.

I beg your pardon?

>s
Jackie's Room
You can see a Wooden Door here.

>drop sword
Dropped.

>n
backyard
You can see a Wooden Door here.

Living Room

>w
East Hallway

>w
West Hallway

>n
Jackie's Room
You can see a Wooden Door and a sword here.

>n
backyard
You can see a Wooden Door here.

Living Room

>s
You can't go that way.

* * *

>e
You can't go that way.

>w
East Hallway

* * *

>w
West Hallway

>w
You can't go that way.

>n
Jackie's Room
You can see a Wooden Door and a sword here.

* * *

You seem to notice some things are out of place so you decide to investigate. You find out that aliens have invaded and have locked you in your house. You need to find a way to get out and stop them! Hint: the second key can be door key or key2.

Paranormal Life
Aliens Invade! by Jackie Wu
Release 1 / Serial number 170227 / Inform 7 build 6M62 (I6/v6.33 lib 6/12N) SD

Living Room
Your normal living room. The walls are adorned by art. West of the living room is the east hallway.

>x walls
The wall. What else is there. Oh wait, there's paintings.

>x art
You look at the drawings and painting and you remember how you got them at a garage sale. The way the brush stroke make the painting pop made you realize you can't pull that off.

>i
You are carrying nothing.

>x me
A somewhat tall, skinny boy. I wouldn't necessarily call myself handsome. I'm wear a t-shirt and jeans.

>w
East Hallway
The east hall. West of here is the west hallway. South is Kelly's bedroom and northeast is the storage room. Go east to go back to the living room.

>x hall
You can't see any such thing.

>s
Kelly's Bedroom
The wall are adorned by giant anime posters. There doesn't seem to be anything of use.

You can see a desk (closed) here.

>x posters
Posters from Hunter X Hunter and Gravitation. You think to yourself that you should watch anime again.

>x giant anime posters
You can't see any such thing.

>x anime posters
Posters from Hunter X Hunter and Gravitation. You think to yourself that you should watch anime again.

>x desk
Very wooden. Very real. Nothing strange here. Move on.

>open desk
It isn't something you can open.

>ne
You can't go that way.

>n
East Hallway
The east hall. West of here is the west hallway. South is Kelly's bedroom and northeast is the storage room. Go east to go back to the living room.

>ne
Storage Room
There's loads of stuff here. You notice a trapdoor and something shiny. Southwest is the east hallway.

You can see a key and a trapdoor (closed) here.

>x trapdoor
You see nothing special about the trapdoor.

>open trapdoor
You open the trapdoor, revealing a sword.

* * *

>take sword
Taken.

>x sword
A long katana like sword. It looks pretty sharp.

>take key
Taken.

>x key
A brass key. It's pretty light. This unlocks the chest.

>sw
East Hallway
The east hall. West of here is the west hallway. South is Kelly's bedroom and northeast is the storage room. Go east to go back to the living room.

* * *

>n
Jackie's Room
You can see a Wooden Door here.

>x door
You see nothing special about the Wooden Door.

>open door
It seems to be locked.

>s
West Hallway
The west hallway. East of here is the east hallway. South is your grandparent's room and north is your room.

>s
Grandparent's Room
Your grandparent's room. What more can I say about it. Northwest is their closet. North is the west hallway.

* * *

>nw
Grandparent's Closet
There's just a lot of clothes here. But there also seems to be a chest. Southeast is the way back.

You can see a chest (closed) here.

>x clothes
Normal clothes. A lot more jackets than anything else though.

>take clothes
That's hardly portable.

>x chest
You see nothing special about the chest.

>open chest
It seems to be locked.

>use key
That's not a verb I recognise.

>open chest with key
You unlock the chest.

>open chest
You open the chest, revealing a book.

* * *

>x book
Pay...ATTENTION...To..THE..INSIDE

The book feels a little heavy.

>take book
Taken.

>open book
It isn't something you can open.

>x book
Pay...ATTENTION...To..THE..INSIDE

In the book is a key2.

The book feels a little heavy.

>take key2
Taken.

>x key2
A heavier key than the first. Why was the key hidden in the book though? This unlocks the wooden door.

>se
Grandparent's Room
Your grandparent's room. What more can I say about it. Northwest is their closet. North is the west hallway.

* * *

>open door
It seems to be locked.

>unlock door with key
That doesn't seem to fit the lock.

>unlock door with key2
You unlock the Wooden Door.

>i
You are carrying:
  a key2
  a book
  a key
  a sword

>open door
You open the Wooden Door.

>enter
You must supply a noun.

>n
backyard
Just a normal backyard...with some alien life forms. South of here is your room. West is inside the space ship.

You can see a Wooden Door here.

>x aliens
Weird head shape and looks slimy. Eugh. Creepy.

>w
AlienSpaceshipInterior
You enter the ship to be amazed by the technology developed by the aliens. East is the backyard, North is the alien kitchen.

>take all
There are none at all available!

>x technology
You can't see any such thing.

>x aliens
You can't see any such thing.

>n
Alien Kitchen.
There's a lot of high tech mumbo jumbo everywhere. I think there is some sort of person here.

You can see an Alien here.

>x alien
A confused alien muttering to themselves in their language. It seems like they're holding two slices of bread.

I don't think that person knows how sandwiches work. They say if you find them a sandwich, he'll give you hints on upcoming puzzles and the last key. There may have been one in the house...

>take bread
The Alien wouldn't be that happy would he.

>x slices of bread
You can't see any such thing.

>x bread
Whole wheat bread. This alien is pretty healthy.

>s
AlienSpaceshipInterior
You enter the ship to be amazed by the technology developed by the aliens. East is the backyard, North is the alien kitchen.

>s
You can't go that way.

>e
backyard
Just a normal backyard...with some alien life forms. South of here is your room. West is inside the space ship.

You can see a Wooden Door here.

>s
Jackie's Room
You can see a Wooden Door here.

>s
West Hallway
The west hallway. East of here is the east hallway. South is your grandparent's room and north is your room.

>e
East Hallway
The east hall. West of here is the west hallway. South is Kelly's bedroom and northeast is the storage room. Go east to go back to the living room.

>e
Living Room
Your normal living room. The walls are adorned by art. West of the living room is the east hallway.

You can see Sandwich here.

>take sandwich
Taken.

* * *

>n
Jackie's Room
You can see a Wooden Door here.

>n
backyard
Just a normal backyard...with some alien life forms. South of here is your room. West is inside the space ship.

You can see a Wooden Door here.

>w
AlienSpaceshipInterior
You enter the ship to be amazed by the technology developed by the aliens. East is the backyard, North is the alien kitchen.

* * *

>x alien
A confused alien muttering to themselves in their language. It seems like they're holding two slices of bread.

I don't think that person knows how sandwiches work. They say if you find them a sandwich, he'll give you hints on upcoming puzzles and the last key. There may have been one in the house...

>give alien sandwich
You hand the sandwich over to the alien. He makes a weird garble sound. It sounded like he thanked you. He pulls out a note, and a key, and hands you the note and key. You feel good about yourself because you helped someone out.

>take note
You already have that.

>x note
First, you must find the power glove and put them on. That is the only way to move the things. Then, there is a key that I have just given you. This key unlocks the final door. After you aquire the glove, you must head into the rooms above the Power Glove Room. Each room needs a specific item to pass. The library wants a place to sleep, the alien living room wants a place to put their books. And the alien living quarters want a place to eat. Move objects by entering the command "Push "Object" "Direction"". Ignore the " when putting in commands. After doing it correctly, a passage should have opened up in the library. Good luck human. It's up to you to stop them.

>x key
Which do you mean, the final key or the key?

>final key
The final key. It unlocks the final door.

>x key
Which do you mean, the final key or the key?

>x power glove
You can't see any such thing.

>look
Alien Kitchen.
There's a lot of high tech mumbo jumbo everywhere. I think there is some sort of person here.

You can see an Alien here.

>talk to alien
That's not a verb I recognise.

>kill alien
Violence isn't the answer to this one.

>s
AlienSpaceshipInterior
You enter the ship to be amazed by the technology developed by the aliens. East is the backyard, North is the alien kitchen.

* * *

>e
You can't go that way.

>s
AlienSpaceshipInterior
You enter the ship to be amazed by the technology developed by the aliens. East is the backyard, North is the alien kitchen.

>west
Power Glove Room
There's a lot of power gloves but they all seem to be frozen in place. But one of them looks like they aren't. North is the library, Northwest is the Alien Living Quarters, Northeast is the Alien Living Room.

You can see Power glove here.

>x power gloves
I only understood you as far as wanting to examine Power glove.

>x power glove
The power glove surges with strength.

>take glove
Taken.

>i
You are carrying:
  Power glove
  a final key
  Note
  a key2
  a book
  a key
  a sword

>combine power glove with sword
That's not a verb I recognise.

>combine note with book
That's not a verb I recognise.

>n
Library
Alien books filled the room. There doesn't seem to be anyone here. South of here is the Power Glove Room.

You can see Bookcase here.

>x bookcase
There's a lot of books but you can't tell what the language is. Seer rumtauto, yucm'g yug?

>take books
You can't see any such thing.

>take book
You already have that.

>move bookcase with power glove
You can't see any such thing.

>x power glove
The power glove surges with strength.

>s
Power Glove Room
There's a lot of power gloves but they all seem to be frozen in place. But one of them looks like they aren't. North is the library, Northwest is the Alien Living Quarters, Northeast is the Alien Living Room.

>nw
Alien Living Quarters
Your normal alien living quarters. Very high tech. Even the bed. Southeast from here is the Power Glove Room.

You can see Bed here.

>wear power glove
You put on Power glove.

>se
Power Glove Room
There's a lot of power gloves but they all seem to be frozen in place. But one of them looks like they aren't. North is the library, Northwest is the Alien Living Quarters, Northeast is the Alien Living Room.

>n
Library
Alien books filled the room. There doesn't seem to be anyone here. South of here is the Power Glove Room.

You can see Bookcase here.

>use power love
That's not a verb I recognise.

>use power glove
That's not a verb I recognise.

>move bookcase
It is fixed in place.

>push bookcase
It is fixed in place.

>push bookcase n
You can't go that way.

>push bookcase west
You can't go that way.

>push bookcase away
You can't see any such thing.

>push bookcase
It is fixed in place.

>look
Library
Alien books filled the room. There doesn't seem to be anyone here. South of here is the Power Glove Room.

You can see Bookcase here.

>s
Power Glove Room
There's a lot of power gloves but they all seem to be frozen in place. But one of them looks like they aren't. North is the library, Northwest is the Alien Living Quarters, Northeast is the Alien Living Room.

* * *

>nw
Alien Living Quarters
Your normal alien living quarters. Very high tech. Even the bed. Southeast from here is the Power Glove Room.

You can see Bed here.

>x bed
It's seems to be a high tech looking bed. Fancy.

>take bed
That's fixed in place.

>se
Power Glove Room
There's a lot of power gloves but they all seem to be frozen in place. But one of them looks like they aren't. North is the library, Northwest is the Alien Living Quarters, Northeast is the Alien Living Room.

>ne
Alien Living Room
High tech stuff everywhere. I can't tell what everything is. Southwest of here is the Power Glove Room.

You can see Dining table here.

>take dining table
That's fixed in place.

>x dining table
Pure steel. It seems really heavy. I wonder how cold it can get.

>freeze dining table
That's not a verb I recognise.

>sw
Power Glove Room
There's a lot of power gloves but they all seem to be frozen in place. But one of them looks like they aren't. North is the library, Northwest is the Alien Living Quarters, Northeast is the Alien Living Room.

>nw
Alien Living Quarters
Your normal alien living quarters. Very high tech. Even the bed. Southeast from here is the Power Glove Room.

You can see Bed here.

>se
Power Glove Room
There's a lot of power gloves but they all seem to be frozen in place. But one of them looks like they aren't. North is the library, Northwest is the Alien Living Quarters, Northeast is the Alien Living Room.

* * *

>n
Library
Alien books filled the room. There doesn't seem to be anyone here. South of here is the Power Glove Room.

You can see Bookcase here.

>take bookcase
That's fixed in place.

>n
You can't go that way.

>place bed
That's not a verb I recognise.

>move bed
You can't see any such thing.

>drop bed
You can't see any such thing.

>s
Power Glove Room
There's a lot of power gloves but they all seem to be frozen in place. But one of them looks like they aren't. North is the library, Northwest is the Alien Living Quarters, Northeast is the Alien Living Room.

* * *

>nw
Alien Living Quarters
Your normal alien living quarters. Very high tech. Even the bed. Southeast from here is the Power Glove Room.

You can see Bed here.

>drop dining table
You can't see any such thing.

>se
Power Glove Room
There's a lot of power gloves but they all seem to be frozen in place. But one of them looks like they aren't. North is the library, Northwest is the Alien Living Quarters, Northeast is the Alien Living Room.

* * *

>ne
Alien Living Room
High tech stuff everywhere. I can't tell what everything is. Southwest of here is the Power Glove Room.

You can see Dining table here.

>i
You are carrying:
  Power glove (being worn)
  a final key
  Note
  a key2
  a book
  a key
  a sword

>drop bookcase
You can't see any such thing.

>sw
Power Glove Room
There's a lot of power gloves but they all seem to be frozen in place. But one of them looks like they aren't. North is the library, Northwest is the Alien Living Quarters, Northeast is the Alien Living Room.

>n
Library
Alien books filled the room. There doesn't seem to be anyone here. South of here is the Power Glove Room.

You can see Bookcase here.

>open secret door
You open the Secret Door.

>n
You can't go that way.

>x final door
I only understood you as far as wanting to examine the final key.

>s
Power Glove Room
There's a lot of power gloves but they all seem to be frozen in place. But one of them looks like they aren't. North is the library, Northwest is the Alien Living Quarters, Northeast is the Alien Living Room.

>s
You can't go that way.

>x alien
You can't see any such thing.

>ne
Alien Living Room
High tech stuff everywhere. I can't tell what everything is. Southwest of here is the Power Glove Room.

You can see Dining table here.

>sw
Power Glove Room
There's a lot of power gloves but they all seem to be frozen in place. But one of them looks like they aren't. North is the library, Northwest is the Alien Living Quarters, Northeast is the Alien Living Room.

* * *

>n
Library
Alien books filled the room. There doesn't seem to be anyone here. South of here is the Power Glove Room.

You can see Bookcase here.

>unlock secret door
What do you want to unlock the Secret Door with?

>key
Which do you mean, the final key or the key?

>final key
That doesn't seem to be something you can unlock.

>unlock secret door
What do you want to unlock the Secret Door with?

>i
You are carrying:
  Power glove (being worn)
  a final key
  Note
  a key2
  a book
  a key
  a sword

>n
You can't go that way.

>unlock final door
I didn't understand that sentence.

>final key
That's not a verb I recognise.

>n
You can't go that way.

>s
Power Glove Room
There's a lot of power gloves but they all seem to be frozen in place. But one of them looks like they aren't. North is the library, Northwest is the Alien Living Quarters, Northeast is the Alien Living Room.

>n
Library
Alien books filled the room. There doesn't seem to be anyone here. South of here is the Power Glove Room.

You can see Bookcase here.

* * *

>push bookcase south
You push Bookcase south to Power Glove Room.

Power Glove Room
There's a lot of power gloves but they all seem to be frozen in place. But one of them looks like they aren't. North is the library, Northwest is the Alien Living Quarters, Northeast is the Alien Living Room.

>look
Power Glove Room
There's a lot of power gloves but they all seem to be frozen in place. But one of them looks like they aren't. North is the library, Northwest is the Alien Living Quarters, Northeast is the Alien Living Room.

You can see Bookcase here.

>x key2
A heavier key than the first. Why was the key hidden in the book though? This unlocks the wooden door.

* * *

>x art
You look at the drawings and painting and you remember how you got them at a garage sale. The way the brush stroke make the painting pop made you realize you can't pull that off.

>x drawings
You can't see any such thing.

>x painting
You can't see any such thing.

>x garage sale
You can't see any such thing.

>take painting
You can't see any such thing.

>w
East Hallway
The east hall. West of here is the west hallway. South is Kelly's bedroom and northeast is the storage room. Go east to go back to the living room.

I beg your pardon?

>s
Kelly's Bedroom
The wall are adorned by giant anime posters. There doesn't seem to be anything of use.

You can see a desk (closed) here.

* * *

>x posters
Posters from Hunter X Hunter and Gravitation. You think to yourself that you should watch anime again.

>take poster
You can't see any such thing.

>x desk
Very wooden. Very real. Nothing strange here. Move on.

* * *

>open desk
It isn't something you can open.

>n
East Hallway
The east hall. West of here is the west hallway. South is Kelly's bedroom and northeast is the storage room. Go east to go back to the living room.

>northeast
Storage Room
There's loads of stuff here. You notice a trapdoor and something shiny. Southwest is the east hallway.

You can see a key and a trapdoor (closed) here.

>x shiny
You can't see any such thing.

>x something shiny
You can't see any such thing.

>x key
A brass key. It's pretty light. This unlocks the chest.

>take key
Taken.

>x trapdoor
You see nothing special about the trapdoor.

* * *

>take sword
Taken.

>equip sword
That's not a verb I recognise.

>use sword
That's not a verb I recognise.

>i
You are carrying:
  a sword
  a key

>look around
You can't see any such thing.

>x room
You can't see any such thing.

>look
Storage Room
There's loads of stuff here. You notice a trapdoor and something shiny. Southwest is the east hallway.

You can see a trapdoor (empty) here.

>sw
East Hallway
The east hall. West of here is the west hallway. South is Kelly's bedroom and northeast is the storage room. Go east to go back to the living room.

* * *

>take clothes
That's hardly portable.

>x jackets
You can't see any such thing.

>take jackets
You can't see any such thing.

>open chest
It seems to be locked.

* * *

>open chest with key
You unlock the chest.

>x chest
You see nothing special about the chest.

>open chest
You open the chest, revealing a book.

>take book
Taken.

>x book
Pay...ATTENTION...To..THE..INSIDE

In the book is a key2.

The book feels a little heavy.

>open book
It isn't something you can open.

>take key2
Taken.

>i
You are carrying:
  a key2
  a book
  a sword
  a key

>look
Grandparent's Closet
There's just a lot of clothes here. But there also seems to be a chest. Southeast is the way back.

You can see a chest (empty) here.

>se
Grandparent's Room
Your grandparent's room. What more can I say about it. Northwest is their closet. North is the west hallway.

* * *

>n
West Hallway
The west hallway. East of here is the east hallway. South is your grandparent's room and north is your room.

>n
Jackie's Room
North of here is the wooden door.

You can see a Wooden Door here.

>open wooden door
It seems to be locked.

>i
You are carrying:
  a key2
  a book
  a sword
  a key

>open wooden door with key2
You unlock the Wooden Door.

>open wooden door
You open the Wooden Door.

>n
backyard
Just a normal backyard...with some alien life forms and a massive space ship. South of here is your room. West is inside the space ship.

You can see a Wooden Door here.

>x alien life forms
You can't see any such thing.

>kill alien life forms
You can't see any such thing.

>w
Alien Spaceship Interior
You enter the ship to be amazed by the technology developed by the aliens. East is the backyard, North is the alien kitchen. West is the Power Glove Room.

>x technoogy\
You can't see any such thing.

>x technology
You can't see any such thing.

* * *

>x aliens
You can't see any such thing.

>n
Alien Kitchen.
There's a lot of high tech mumbo jumbo everywhere. I think there is some sort of person here. South is the Alien Space Ship Interior.

You can see an Alien here.

>x high tech mumbo jumbo
You can't see any such thing.

>x perso
You can't see any such thing.

>x person
You can't see any such thing.

>talk person
That's not a verb I recognise.

>x alien
A confused alien muttering to themselves in their language. It seems like they're holding two slices of bread.

I don't think that person knows how sandwiches work. They say if you find them a sandwich, he'll give you hints on upcoming puzzles and the last key. There may have been one in the house...

* * *

>take bread
The Alien wouldn't be that happy would he.

>look
Alien Kitchen.
There's a lot of high tech mumbo jumbo everywhere. I think there is some sort of person here. South is the Alien Space Ship Interior.

You can see an Alien here.

>s
Alien Spaceship Interior
You enter the ship to be amazed by the technology developed by the aliens. East is the backyard, North is the alien kitchen. West is the Power Glove Room.

>e
backyard
Just a normal backyard...with some alien life forms and a massive space ship. South of here is your room. West is inside the space ship.

You can see a Wooden Door here.

>s
Jackie's Room
North of here is the wooden door.

You can see a Wooden Door here.

>s
West Hallway
The west hallway. East of here is the east hallway. South is your grandparent's room and north is your room.

* * *

>w
West Hallway
The west hallway. East of here is the east hallway. South is your grandparent's room and north is your room.

>n
Jackie's Room
North of here is the wooden door.

You can see a Wooden Door here.

>n
backyard
Just a normal backyard...with some alien life forms and a massive space ship. South of here is your room. West is inside the space ship.

You can see a Wooden Door here.

>w
Alien Spaceship Interior
You enter the ship to be amazed by the technology developed by the aliens. East is the backyard, North is the alien kitchen. West is the Power Glove Room.

>n
Alien Kitchen.
There's a lot of high tech mumbo jumbo everywhere. I think there is some sort of person here. South is the Alien Space Ship Interior.

You can see an Alien here.

>give sandwich to alien
You hand the sandwich over to the alien. He makes a weird garble sound. It sounded like he thanked you. He pulls out a note, and a key, and hands you the note and key. You feel good about yourself because you helped someone out.

>i
You are carrying:
  a final key
  Note
  a key2
  a book
  a sword
  a key

>x note
First, you must find the power glove and put them on. That is the only way to move the things. Then, there is a key that I have just given you. This key unlocks the final door. After you have aquired the glove, you must head into the rooms above the Power Glove Room. Each room needs a specific item to pass. The library wants a place to sleep, the alien living room wants a place to put their books. And the alien living quarters want a place to eat. Move objects by entering the command "Push "Object" "Direction"". Ignore the " when putting in commands. After doing it correctly, a passage should have opened up in the library. Good luck human. It's up to you to stop them.

>x final key
The final key. It unlocks the final door.

>s
Alien Spaceship Interior
You enter the ship to be amazed by the technology developed by the aliens. East is the backyard, North is the alien kitchen. West is the Power Glove Room.

* * *

>e
backyard
Just a normal backyard...with some alien life forms and a massive space ship. South of here is your room. West is inside the space ship.

You can see a Wooden Door here.

>w
Alien Spaceship Interior
You enter the ship to be amazed by the technology developed by the aliens. East is the backyard, North is the alien kitchen. West is the Power Glove Room.

>w
Power Glove Room
There's a lot of power gloves but they all seem to be frozen in place. But one of them looks like they aren't. North is the library, Northwest is the Alien Living Quarters, Northeast is the Alien Living Room.

You can see Power glove here.

>take power glove
Taken.

>put on power glove
You put on Power glove.

>north
Library
Alien books filled the room. There doesn't seem to be anyone here. South of here is the Power Glove Room.

You can see Bookcase here.

>x bookcase
There's a lot of books but you can't tell what the language is. Seer rumtauto, yucm'g yug?

>x note
First, you must find the power glove and put them on. That is the only way to move the things. Then, there is a key that I have just given you. This key unlocks the final door. After you have aquired the glove, you must head into the rooms above the Power Glove Room. Each room needs a specific item to pass. The library wants a place to sleep, the alien living room wants a place to put their books. And the alien living quarters want a place to eat. Move objects by entering the command "Push "Object" "Direction"". Ignore the " when putting in commands. After doing it correctly, a passage should have opened up in the library. Good luck human. It's up to you to stop them.

>take books
You can't see any such thing.

>use power glove
That's not a verb I recognise.

>s
Power Glove Room
There's a lot of power gloves but they all seem to be frozen in place. But one of them looks like they aren't. North is the library, Northwest is the Alien Living Quarters, Northeast is the Alien Living Room.

* * *

>take bed
That's fixed in place.

>kill bed
Violence isn't the answer to this one.

>use sword
That's not a verb I recognise.

>se
Power Glove Room
There's a lot of power gloves but they all seem to be frozen in place. But one of them looks like they aren't. North is the library, Northwest is the Alien Living Quarters, Northeast is the Alien Living Room.

* * *

>ne
Alien Living Room
High tech stuff everywhere. I can't tell what everything is. Southwest of here is the Power Glove Room.

You can see Dining table here.

>x dining table
Pure steel. It seems really heavy. I wonder how cold it can get.

* * *

>freeze dining table
That's not a verb I recognise.

>use power glove
That's not a verb I recognise.

>x note
First, you must find the power glove and put them on. That is the only way to move the things. Then, there is a key that I have just given you. This key unlocks the final door. After you have aquired the glove, you must head into the rooms above the Power Glove Room. Each room needs a specific item to pass. The library wants a place to sleep, the alien living room wants a place to put their books. And the alien living quarters want a place to eat. Move objects by entering the command "Push "Object" "Direction"". Ignore the " when putting in commands. After doing it correctly, a passage should have opened up in the library. Good luck human. It's up to you to stop them.

>push dining table w
You can't go that way.

>push dining table sw
You push Dining table southwest to Power Glove Room.

Power Glove Room
There's a lot of power gloves but they all seem to be frozen in place. But one of them looks like they aren't. North is the library, Northwest is the Alien Living Quarters, Northeast is the Alien Living Room.

* * *

>push dining table nw
You push Dining table northwest to Alien Living Quarters.

Alien Living Quarters
Your normal alien living quarters. Very high tech. Even the bed. Southeast from here is the Power Glove Room.

You can see Bed here.

>x note
First, you must find the power glove and put them on. That is the only way to move the things. Then, there is a key that I have just given you. This key unlocks the final door. After you have aquired the glove, you must head into the rooms above the Power Glove Room. Each room needs a specific item to pass. The library wants a place to sleep, the alien living room wants a place to put their books. And the alien living quarters want a place to eat. Move objects by entering the command "Push "Object" "Direction"". Ignore the " when putting in commands. After doing it correctly, a passage should have opened up in the library. Good luck human. It's up to you to stop them.

>push bed se
You push Bed southeast to Power Glove Room.

Power Glove Room
There's a lot of power gloves but they all seem to be frozen in place. But one of them looks like they aren't. North is the library, Northwest is the Alien Living Quarters, Northeast is the Alien Living Room.

>push bed n
You push Bed north to Library.

Library
Alien books filled the room. There doesn't seem to be anyone here. South of here is the Power Glove Room.

You can see Bookcase here.

>s
Power Glove Room
There's a lot of power gloves but they all seem to be frozen in place. But one of them looks like they aren't. North is the library, Northwest is the Alien Living Quarters, Northeast is the Alien Living Room.

>x note
First, you must find the power glove and put them on. That is the only way to move the things. Then, there is a key that I have just given you. This key unlocks the final door. After you have aquired the glove, you must head into the rooms above the Power Glove Room. Each room needs a specific item to pass. The library wants a place to sleep, the alien living room wants a place to put their books. And the alien living quarters want a place to eat. Move objects by entering the command "Push "Object" "Direction"". Ignore the " when putting in commands. After doing it correctly, a passage should have opened up in the library. Good luck human. It's up to you to stop them.

>n
Library
Alien books filled the room. There doesn't seem to be anyone here. South of here is the Power Glove Room.

You can see Bed and Bookcase here.

>move bookcase s
You push Bookcase south to Power Glove Room.

Power Glove Room
There's a lot of power gloves but they all seem to be frozen in place. But one of them looks like they aren't. North is the library, Northwest is the Alien Living Quarters, Northeast is the Alien Living Room.

>move bookcase ne
You push Bookcase northeast to Alien Living Room.

Alien Living Room
High tech stuff everywhere. I can't tell what everything is. Southwest of here is the Power Glove Room.

>sw
Power Glove Room
There's a lot of power gloves but they all seem to be frozen in place. But one of them looks like they aren't. North is the library, Northwest is the Alien Living Quarters, Northeast is the Alien Living Room.

>s
You can't go that way.

>n
Library
Alien books filled the room. There doesn't seem to be anyone here. South of here is the Power Glove Room.

You can see Bed and a Secret Door here.

>walk secret door
(first opening the Secret Door)

Hidden Room
There seems to be one last door. But it's locked. You remember the alien gave you a key. You should check your inventory.

You can see a Secret Door and Final door here.

>open last door with last key
You unlock Final door.

>i
You are carrying:
  Power glove (being worn)
  a final key
  Note
  a key2
  a book
  a sword
  a key

>open last door with final key
That's unlocked at the moment.

>open final door with final key
That's unlocked at the moment.

>walk through final door
(first opening Final door)

AlienCockpit
You can see Final door here.

You see the switch to stop orders to take over earth. Quickly, you flick the switch. Big red words appear on the glass of the cock pit saying things in an alien language. It's over...

    *** The End ***

Would you like to RESTART, RESTORE a saved game, QUIT or UNDO the last command?